1111111111111111111111111111
1OOOOOOO111111C1111111111111
1000000000000000001111111121
1111000000P11111111111111131
1111111111111111111111111141
