1111111111111111111111111111
10000000111111C1111111111111
1000000000000000E01111111111
1111000000P11111111111111111
1111111111111111111111111111
