11111111111111111111111111111111111
10000000000000000000000000000000011
10P00000000000000000000000C00000011
10000111000000011100000000000000011
10000111000000011100000000000000011
10000111000C00011100000000000000111
1000011100000001110C000000000100011
10000111000000011100000000001000111
10000111111111111100000000000100011
10000111111111111100000000001000111
10000111000000011100000000000100011
10000111000C00011100000000000100011
1000011100000001110C000000000100011
10000111000000011100000000010001111
10000000000000000000000000000100011
10000000000000000000000000000C00011
10000000000000000000000000000000011
1000000C00000000000000000000000E011
10000000000000C00000000000000000011
11111111111111111111111111111111111