1111111111111111111111111111
100000001111C111C11111111111
10C0000000000000E01111111111
111100C000P11C11111111111111
1111111111111111111111111111
