11111111111111111111111111111111111
10000000000000000000000000000000011
10P00000000000000000000000C00000011
10000000000000000000000000000000011
10000C00000000000000000000000000011
10000000000000000000000000000000011
10000000000000000000000000000000011
10000000000000000000000000000000011
100000000C0000000000000000000000011
10000000000000000000000000000000011
10000000000000000000000000000000011
10000000000000000000000000000000011
1000000000000000000C000000000000011
10000000000000000000000000000000011
10000000000000000000000000000000011
10000000000000000000000000000C00011
10000000000000000000000000000000011
1000000C00000000000000000000000E011
10000000000000000000000000000000011
11111111111111111111111111111111111