1111111111111
1001000000E00
1000010000001
1PCC010000001
111111111111